..........
.#######..
.#........
..........
.#........
.#######..
..........

\robot 9 6
\robot 0 0
